cultivation|the process of preparing the land for growing crops|True|True|True
irrigation|a means of supplying water for agriculture|True|True|True
precipitation|water that falls to the Earthâ€™s surface|True|True|True
a famine|severe hunger; a drastic food shortage|True|True|True
catastrophic|extremely harmful|True|True|True
to abandon|to leave, to give up|True|True|True
to fertilize|to supply nourishment to plants|True|True|True
photosynthesis|the process by which plants combine light energy into chemical energy|True|False|True
to collide|to come together with great or violent force|True|False|True
an eruption|a sudden, often violent, outburst|True|False|True
a flood|an overflowing of water; an excessive amount|False|False|False
to plunge|to go down suddenly|False|False|False
combustion|burning|False|False|False
solar|relating to the sun|False|False|False
an emission|a substance discharged into the air|False|False|False
to convey|to transport from one place to another|False|False|False
a source|a point of origin|False|False|False
a constraint|a restriction|False|False|False
stable|firm and dependable|False|False|False
astrological|related to the study of the position of stars and their supposed effect & on earthly events|False|False|False
divination|foretelling the future by finding patterns in physical objects|False|False|False
self-perpetuating|having the power to renew oneself|False|False|False
to haunt|to continually appear as a ghost|False|False|False
to invoke|to call on for support|False|False|False
a phantom|a ghost|False|False|False
a generation|a group of people born at about the same time|False|False|False
inherent|a natural characteristic of something|False|False|False
a process|a series of steps leading to a result|False|False|False
to survive|to continue living|False|False|False
acquisition|the act of taking possession of something|False|False|False
